o o o f o
o b o b o
o b o b o
o s o o o
b b o o b





