o o o f o
s b o b o
o o O o o
o b o o o
o o o o o





