o o o o o
o b o o f
o o S o o
b b o b o
b b o o o





